original	replacement
ndi_app_markgarbage	ndi.app.markgarbage
ndi_app_oridirtuning	ndi.app.oridirtuning
ndi_app_spikeextractor	ndi.app.spikeextractor
ndi_app_spikesorter	ndi.app.spikesorter
ndi_app_spikesorter_hengen	ndi.app.spikesorter.hengen
ndi_app_stimulus_decoder	ndi.app.stimulus.decoder
ndi_app_tuning_response	ndi.app.stimulus.tuning_response
ndi_appdoc	ndi.app.appdoc
ndi_daqmetadatareader	ndi.daq.metadatareader.metadatareader
ndi_daqmetadatareader_AngelucciStims	ndi.daq.metadatareader.AngelucciStims
ndi_daqmetadatareader_NewStimStims	ndi.daq.metadatareader.NewStimStims
ndi_daqsystemstring	ndi.daq.metadata.daqsystemstring
ndi_epochprobemap_daqsystem	ndi.daq.metadata.epochprobemap_daqsystem
ndi_epochprobemap_daqsystem_vhlab	ndi.daq.metadata.epochprobemap_daqsystem_vhlab
ndi_daqreader	ndi.daq.reader.base
ndi_daqsystem	ndi.daq.system.base
ndi_daqreader_mfdaq_blackrock	ndi.daq.reader.mfdaq.blackrock
ndi_daqreader_mfdaq_cedspike2	ndi.daq.reader.mfdaq.cedspike2
ndi_daqreader_mfdaq_intan	ndi.daq.reader.mfdaq.intan
ndi_daqreader_mfdaq_spikegadgets	ndi.daq.reader.mfdaq.spikegadgets
ndi_daqreader_mfdaq_stimulus_angelucci_visstim	ndi.daq.reader.mfdaq.stimulus.angelucci_visstim
ndi_daqreader_mfdaq_stimulus_vhlabvisspike2	ndi.daq.reader.mfdaq.stimulus.vhlabvisspike2
ndi_daqreader_mfdaq	ndi.daq.reader.mfdaq.mfdaq
ndi_daqsystem_mfdaq	ndi.daq.system.mfdaq.mfdaq
ndi_createGenBankControlledVocabulary	ndi.database.fun.createGenBankControlledVocabulary
ndi_createNIFbrainareas	ndi.database.fun.createNIFbrainareas
ndi_databasehierarchyinit	ndi.database.fun.databasehierarchyinit
ndi_docs2graph	ndi.database.fun.docs2graph
ndi_document2ndi_object	ndi.database.fun.document2ndi_object
ndi_findalldependencies	ndi.database.fun.findalldependencies
ndi_finddocs_missing_dependencies	ndi.database.fun.finddocs_missing_dependencies
ndi_opendatabase	ndi.database.fun.opendatabase
ndi_plotinteractivedocgraph	ndi.database.fun.plotinteractivedocgraph
ndi_projectvardef	ndi.database.fun.projectvardef
ndi_readGenBankNames	ndi.database.fun.readGenBankNames
ndi_readGenBankNodes	ndi.database.fun.readGenBankNodes
ndi_binarydoc_matfid	ndi.database.binarydoc.matfid
ndi_matlabdumbjsondb	ndi.database.matlabdumbjsondb
ndi_postgresdb	ndi.database.postgresdb
ndi_binarydoc	ndi.database.binarydoc
ndi_database	ndi.database
ndi_document	ndi.document
ndi_documentservice	ndi.documentservice
ndi_query	ndi.query
ndi_validate	ndi.validate
ndi_evaluate_fitcurve	ndi.data.evaluate_fitcurve
ndi_hengen_demo	ndi.demo.hengen
ndi_spikes_demo	ndi.demo.spikes
ndi_tutorial	ndi.demo.tutorial
ndi_tutorial_revised	ndi.demo.tutorial_revised
epochdemo1	ndi.demo.epochdemo1
ndi_getdaqsfromprobe	ndi.demo.session.getdaqsfromprobe
ndi_getsessioninfo	ndi.demo.session.getsessioninfo
syncgraph_example_figure	ndi.demo.syncgraph_example_figure
ndi_changeobjectname	ndi.demo.changeobjectname
ndi_element	ndi.element.base
ndi_element_timeseries	ndi.element.timeseries
ndi_neuron_hengen	ndi.neuron.hengen
ndi_epochprobemap	ndi.epoch.epochprobemap
ndi_epochset	ndi.epoch.epochset
ndi_epochset_param	ndi.epoch.epochset_param
ndi_findepochnode	ndi.epoch.findepochnode
ndi_filenavigator	ndi.file.navigator
ndi_filenavigator_epochdir	ndi.file.navigator.epochdir
ndi_gui	ndi.gui
ndi_gui_v2	ndi.gui_v2
ndi_convertoldnsd2ndi	ndi.fun.convertoldnsd2ndi
ndi_filesep	ndi.filesep
ndi_globals	ndi.globals
ndi_id	ndi.ido
ndi_install	ndi_install
ndi_stimulustemporalfrequency	ndi.fun.stimulustemporalfrequency
ndi_version	ndi.version
ndi_app	ndi.app
ndi_probe	ndi.probe
ndi_probestruct2probe	ndi.probe.fun.probestruct2probe
ndi_probetype2objectinit	ndi.probe.fun.probetype2objectinit
ndi_probe_timeseries	ndi.probe.timeseries
ndi_probe_timeseries_mfdaq	ndi.probe.timeseries.mfdaq
ndi_probe_timeseries_stimulator	ndi.probe.timeseries.stimulator
ndi_session	ndi.session.session
ndi_session_dir	ndi.session.dir
ndi_sessiontable	ndi.sessiontable
ndi_angeluccilab_expdir	ndi.setups.angeluccilab_expdir
ndi_angeluccilab_makedev	ndi.setups.angeluccilab_makedev
ndi_katzlab_expdir	ndi.setups.katzlab_expdir
ndi_katzlab_makedev	ndi.setups.katzlab_makedev
ndi_marderlab_expdir	ndi.setups.marderlab_expdir
ndi_marderlab_makedev	ndi.setups.marderlab_makedev
ndi_vhlab_expdir	ndi.setups.vhlab_expdir
ndi_vhlab_makedev	ndi.setups.vhlab_makedev
ndi_subject	ndi.subject
ndi_test_markgarbage	ndi.test.app.markgarbage
ndi_test_spikeextractor	ndi.test.app.spikeextractor
test_ndi_cache	ndi.test.cache
build_intan_flat_exp	ndi.test.daq.build_intan_flat_exp
test_blackrock	ndi.test.daq.test_blackrock
test_intan_flat	ndi.test.daq.test_intan_flat
test_intan_flat_metadata	ndi.test.daq.test_intan_flat_metadata
test_intan_flat_saved	ndi.test.daq.intan_flat_saved
test_ndi_device_image_tiffstack	ndi.test.daq.ndi_device_image_tiffstack
test_ndi_image_tiffstack_multipleepoch	ndi.test.daq.ndi_image_tiffstack_multipleepoch
test_sg_flat	ndi.test.daq.sg_flat
test_ndi_daq_documents	ndi.test.daq.documents
test_ndi_daqreader_documents	ndi.test.daq.reader.documents
test_ndi_daqsystem_documents	ndi.test.daq.system.documents
test_ndi_filenavigator_documents	ndi.test.daq.filenavigator.documents
test_ndi_syncgraph_documents	ndi.test.syncgraph.documents
test_ndi_syncrule_documents	ndi.test.syncrule.documents
test_ndi_document	ndi.test.document
test_ndi_document_jsons	ndi.test.document_jsons
test_ndi_validate	ndi.test.document_validate
testpostgresdb	ndi.test.database.testpostgresdb
testpostgresdb2	ndi.test.database.testpostgresdb2
testpostgresdbsearch	ndi.test.database.testpostgresdbsearch
ndi_debug_database_stats	ndi.test.database.debug_stats
test_ndi_element	ndi.test.element
test_ndi_filenavigator	ndi.test.filenavigator
test_ndi_filenavigator_fileIDfunction	ndi.test.filenavigator.fileIDfunction
test_ndi_probe	ndi.test.probe
ndi_test_sessiontable	ndi.test.sessiontable
ndi_angeluccilab_test	ndi.test.setups.angeluccilab_test
ndi_katzlab_narendra_test	ndi.test.setups.katzlab.narendra_test
ndi_marderlab_hamood_test	ndi.test.setups.marderlab.hamood_test
ndi_testvhlabsetup	ndi.test.setups.vhlabsetup_test
ndi_testsuite	ndi.test.testsuite
ndi_clocktype	ndi.time.clocktype
ndi_syncgraph	ndi.time.syncgraph
ndi_syncrule	ndi.time.syncrule
ndi_syncrule_filematch	ndi.time.syncrule.filematch
ndi_timemapping	ndi.time.timemapping
ndi_timereference	ndi.time.timereference
ndi_timeseries	ndi.time.timeseries
